25 25 100
XXXXXXXXXXXXXXXXXXXXXXXXX
X.6.X...XooX.............
X.H.X....o.X....9........
X.7oX...X2BX.............
....B...XBPE......2......
X.X.X.X.X.XXXXXXXXXXXXXXX
X........................
X..X..X..X..X..X..X..X..X
XH...X..X..X..X..X..X..X.
X..X..X..X..X..X..X..X..X
X...............o........
X..X..X..X..X..X..X..X..X
X..X..X3.X..X1.X..X..X..X
X..X..X..X..X..X..X..X..X
XH...X..X..X..X..X..X..X.
Xo......1................
XXXXXXXXXXXXXXXXXXXXXXXXX
X.6.....oBHB.............
X....o....H7.............
XXXXXXXXXXXXXXXXXXXXXXXXX
X..H.....X.....H.......9.
XXXXXXXXXXXXXXXXXXXXXXXXX
.........................
XXXXXXXXXXXXXXXXXXXXXXXXX