22 25 100
XXXXXXXXXXXXXXXXXXXXXXXXX
X...X...XooX.............
X.H.X...XooX....9........
X.HoX...X2.X.............
....B...X.PE......2......
XXXXXXXXXXXXXXXXXXXXXXXXX
X........................
X..X..X..X..X..X..X..X..X
XH...X..X..X..X..X..X..X.
X..X..X..X..X..X..X..X..X
X...............o........
X..X..X..X..X..X..X..X..X
X..X..X..X..X1.X..X..X..X
XXXXXXXXXXXXXXXXXXXXXXXXX
XXXXXXXXXXXXXXXXXXXXXXXXX
Xo......1................
X...B.........BBBBBBBBBBB
X.......oBHB.............
X....o....H..............
XXXXXXXXXXXXXXXXXXXXXXXXX
X..H.....X.....H.......9.
XXXXXXXXXXXXXXXXXXXXXXXXX